################################################################################
#..............................................................................#
#..............................................................................#
#..............................................................................#
#......................**********...*********.......*********..................#
#......................*................*...............*......................#
#......................*................*...............*......................#
#......................*................*...............*......................#
#......................*................*...............*......................#
#......................*................*...............*......................#
#......................********.........*...............*......................#
#......................*................*...............*......................#
#......................*................*...............*......................#
#......................*................*...............*......................#
#......................*................*...............*......................#
#......................*................*...............*......................#
#......................*............*********...........*......................#
#..............................................................................#
################################################################################
#..............................................................................#
#..............................................................................#
#..............................................................................#
#..............................................................................#
################################################################################

