################################################################################
#..............................................................................#
#..............................................................................#
#..............................................................................#
#..............................................................................#
#.................****************************************.....................#
#..............................................................................#
#..............................................................................#
#..............................................................................#
#..............................................................................#
#..............................................................................#
#.................****************************.................................#
#..............................................................................#
#..............................................................................#
#..............................................................................#
#..............................................................................#
#..............................................................................#
#..............................................................................#
################################################################################
#..............................................................................#
#..............................................................................#
#..............................................................................#
#..............................................................................#
################################################################################

