################################################################################
#..............................................................................#
#..............................................................................#
#.................****************************************.....................#
#..............................................................................#
#..............................................................................#
#..............................................................................#
#..............................................................................#
#..............................................................................#
#......................******************************..........................#
#..............................................................................#
#..............................................................................#
#..............................................................................#
#..............................................................................#
#..............................................................................#
#.......................******************************.........................#
#..............................................................................#
#..............................................................................#
################################################################################
#..............................................................................#
#..............................................................................#
#..............................................................................#
#..............................................................................#
################################################################################

